2 3 1 1 1 3 4 4 4 3 2 2 2 3 1 1 1 3
2 2 3 1 1 1 3 4 4 4 3 2 2 2 3 1 1 1
2 2 2 3 1 1 1 3 4 4 4 3 2 2 2 3 1 1
3 2 2 2 3 1 1 1 3 4 4 4 3 2 2 2 3 1
4 3 2 2 2 3 1 1 1 3 4 4 4 3 2 2 2 3
4 4 3 2 2 2 3 1 1 1 3 4 4 4 3 2 2 2
4 4 4 3 2 2 2 3 1 1 1 3 4 4 4 3 2 2
